NO assets/textures/brick.xpm
SO assets/textures/stone.xpm
EA assets/textures/wood.xpm
WE assets/textures/metal.xpm

C 0,132,255
F 45,5,5

1111111111
1S01000001
1001001101
1011101001
1000001101
1000000001
1011011001
1010001101
1010000 00
1111111111
