NO ./pat_no
SO ./pat_so
EA ./pat_ea
WE ./pat_we


C 45,5,5


1111
10W01
1111
