NO assets/textures/brick.xpm
SO assets/textures/brick.xpm
EA assets/textures/metal.xpm
WE assets/textures/metal.xpm

C 05,00,05
F 100,100,90

   

                                                        111111
                                                        1000011111111
                11111111111111111                       11000000000001
                100000000000000011111111111111111111111111000000000001
                100000000000000000000000000000000000000000000000000001
                100000000000000011111111111111111001111111111111011111
                10000000000000001               1001           101
                10000000000000001               1001           101111111111111111
                10000000000000001               1001           100000000000000001
                10000000000000001           111110011111       111111111111111101
                10000000000000001           100000000001                      101
                10000000000000001           100000000001                      101
                10000000000000000111111111111000000000011111111111111111111111101
                10000000000000000000000000000000000000000000000000000000000000001
                11111011111111111111111111111000100000011111111111111111111111101
                    101                     100000000001                      101
                11111011111111111           100000000001                      101
                10000000000000001           111110011111                      101
                10000000000000001               1001                          101
                10000000000000001111111111111111100111111111111111111111111111101
                10000000000000000000000000000000000000000000000000000000000000001
                10000000000000001111111111111111111111111111111111111111111111111
                10000000000000001
                10000000000000001                1                                                   1111
                10000000000000001            1                                                       1001
                10000000000000001              1                                                     1111
                10000000000000001111111111111
                10000000000000000000000000001
                11111111111111111111111111001
                                         1001
                                         1000111111111
11111111111111111                        1000000000001
100000000000000011111111111111111111111111000000000001
100000000000000000000000000000000000000000000000000001
100000000000000011111111111111111001111111111111011111
10000000000000001               1001           101
10000000000000001               1001           101111111111111111
10000000000000001               1001           100000000000000001
10000000000000001           111110011111       111111111111111101
10000000000000001           100000000001                      101
10000000000000001           100000000001                      101
10000000000000001111111111111000000000011111111111111111111111101111111111111111111111111111111111111111111111111111111111111111111111111111111111111111111111111111111
10000000000N00000000000000000000000000000000000000000000000000000000000000000000000000000000000000000000000000000000000000000000000000000000000000000000000000000000001
11111011111111111111111111111000000000011111111111111111111111101111111111111111111111111111111111111111111111111111111111111111111111111111111111111111111111111111111
    101                     100000000001                      101
11111011111111111           100000000001                      101
10000000000000001           111110011111            1         101
10000000000000001               1001                          101
10000000000000001111111111111111100111111111111111111111111111101
10000000000000000000000000000000000000000000000000000000000000001
10000000000000001111111111111111111111111111111111111111111111111
10000000000000001
10000000000000001                               1
10000000000000001                                                                           1
10000000000000001
10000000000000001                           1
10000000000000001
11111111111111111
111111                                                          1
1111                            1
111
111 1