NO assets/textures/brick.xpm
SO assets/textures/stone.xpm
EA assets/textures/wood.xpm
WE assets/textures/metal.xpm

C 0,132,255
F

1111111111
1S01000001      111111111111
1001001101      100000000001
1011101001      100000000001
1000001101      100000000001
1000000001      100000000001
1011011001      100000000001
1010001101111111101111111111
1010000000000000001
1111111111111011111
            101
            111
